########################
#......................#
#.........p............#
#......................#
#......................#
#..77777777777777777...#
#..666666666666666666..#
#.55555555555555555555.#
#pppppppppppppppppppppp#
#oooooooooooooooooooooo#
#iiiiiiiiiiiiiiiiiiiiii#
#++++++++++++++++++++++#
#----------------------#
#**********************#
#//////////////////////#
#======================#
#,,,,,,,,,,,,,,,,,,,,,,#
#::::::::::::::::::::::#
#......................#
#4.4.4.4.4.4.4.4.4.4.4.#
#.3.3.3.3.3.3.3.3.3.3.3#
#2.2.2.2.2.2.2.2.2.2.2.#
#.1.1.1.1.1.1.1.1.1.1..#
########################