[[[[[[[[[[[[[[[[[[[[[[[[
[;;;;;;;;;;;;;;;;;;;;;;[
[;;;;;;;;;;;;;;;;;;;;;;[
[;;;;;;/;;;;/;;;;;;;;;;[
[;;;;;;;;;;;;;;;;;;;;;;[
[======;;;;;;;;;;;;;;;;[
[[[[[[[;;;;;;;;/;;;;;;;[
[;;;;;;;;;;;;;;;;;;;;;;[
[;;;;;;;;;;;;==========[
[;;;;;;;;;;;;[[[[[[[[[[[
[;;;/;;;;;;;;;;;;;;;;;;;
[;;;;;;;;;;;;;;;;;;;;;;;
[;;;;;;;;;;;;;;/;;;;;;;;
[;;;;;;;;;;;;;==========
[;;;;;;;;;;;;;[[[[[[[[[[
[;;;;;;=;;;;;;;;;;;;;;;[
[;;;;;;;;;;;;;;;;;;;;;;[
[;;;/;;;;;;;;;;/;;;;;;;[
[;;;;;;;;;;;;;;;;;;;;;;[
[;;;;;;;;;/;;;;;;;;;;;;[
[======;;;;;;;;;;;;;;;;[
[[[[[[[;;;;;;;;/;;;;;;;[
[;;;;;;;;;;;;;;;;;;;;;;[
[[[[[[[[[[[[[[[[[[[[[[[[
************************
************************
************************
**1*********************
************************
************************
************************
************************
************************
************************
************************
*********************p**
************************
*******3****************
************************
************************
******************1*****
************************
************************
************************
**********2*************
************************
************************
************************